R 500 500
NO ./pics/goop.xpm
SO ./pics/woody.xpm
WE ./pics/lookyface.xpm
EA ./pics/leakybuzz.xpm
S ./pics/swolmo.xpm
F 50,0,0
C 5,9,50

111111111111111
100000000000001
100000000000001
100000000000001
100000000000001
100000011111111
10000001
10000011
100000011111111
100000000020001
100000000002001
10N000000000001
100000000000001
111111111111111
