R 500 500
NO ./pics/goop.xpm
SO ./pics/leakybuzz.xpm
WE ./pics/goop.xpm
EA ./pics/lookyface.xpm
S ./pics/swolmo.xpm
F 50,0,0
C 5,9,50


11111111111111111
10000000000000001
1N001002000001111111111
1002000111111111111111111111
111111111111
