R 2900 8000
NO ./pics/goop.xpm
SO ./pics/woody.xpm
WE ./pics/woody.xpm
EA ./pics/lookyface.xpm
S ./pics/swolmo.xpm
F 50,0,0
C 5,9,50


1111111111111111111111111
1000000000110000000000001
1011000001110000000020001
1001000000000000000000001
111111111011000001110000000000001
100020000011000001110111111111111
11110111111111011100000010001
11110111111111011101010010201
11000000110101011100000010001
10000000000000001100000010001
10000000000000001101010010201
11000001110101011111011110N0111
11110111111101011101111010001
11111111111111111111111111111