R 500 500
NO ./pics/goop.xpm
SO ./pics/woody.xpm
WE ./pics/lookyface.xpm
EA ./pics/leakybuzz.xpm
S ./pics/swolmo.xpm
F 50,0,0
C 5,9,50

111111111111111
100000000000001
100000000000001
100000000000001
100000000000001
100000000000001
100000000000001
100000000000001
100000000000001
100000000000001
1000000N0000001
111111111111111