R 500 500
NO ./pics/goop.xpm
SO ./pics/woody.xpm
WE ./pics/lookyface.xpm
EA ./pics/leakybuzz.xpm
S ./pics/swolmo.xpm
F 100,100,100
C 0,9,20

111111111111111111111111111111111111111111111
100000000000001100000000000001100000000000001
100000000000001100000000000001100000000000001
100000000000001100000002000001100000000000001
100000000000001100000000000001100000000000001
100000000000001100000200000001100000000000001
100000000000001100000000000001100000002000001
100000000000001100000200000001100000000000001
100000000000000000000000000000000000000000111
100000000000001100000000000001100000000000001
100000000000001100000000000001100000000000001
100000000000001100000000000001100000000000001
100000000000001100000000000000000000000000001
100000000000001100000002000001100000000000001
100000000000001100000000000001100000000000001
100000000000001100000200000001100000000000001
100000000000001100000000000001100000002000001
100000000000001100000200000001100000000000001
10000N000000000000000000000000000000000000111
100000000000001100000000000001100000000000001
100000000000001100000000000001100000000000001
100000000000001100000000000001100000000000001
100000000000001100000000000001100000000000001
100000000000001100000002000001100000000000001
100000000000001100000000000001100000000000001
100000000000001100000200000001100000000000001
100000000000001100000000000001100000002000001
100000000000001100000200000001100000000000001
100000000000000000000000000010000000000000111
100000000000001100000000000001100000000000001
100000000000001100000000000001100000000000001
111111111111111111111111111111111111111111111