R 600 600
NO ./pics/not_a_real_file.xpm
SO ./pics/woody.xpm
WE ./pics/leakybuzz.xpm
EA ./pics/lookyface.xpm
S ./pics/swolmo.xpm
F 50,0,0
C 5,9,50

111111
100001
102001
100001
100001
100001
1000011111111111111111111111111
1000000000000000000000000000001
10N0000000000000000000000000001
1111111111111111111111111111111