R 600 600
NO ./pics/leakybuzz.xpm
SO ./pics/goop.xpm
WE ./pics/lookyface.xpm
EA ./pics/woody.xpm
S ./pics/swolmo.xpm
F 50,0,0
C 5,9,50


11111111111111111
10000000000000001
1E001002000021111111111
1002000111111111111111111111
100001111111
100001
100001
100001
111111

